46 32
1 2 3 4 5 6 7 8 9 10 11 12 13 14 15 16 17 18 19 0 0 0 0 0 0 0 0 0 0 0 0 0 0 0 0 0 0 0 0 0 0 0 0 0 0 0  
0 0 0 0 0 0 0 0 0 0 0 0 0 0 0 4 4 4 0 0 0 0 0 0 0 0 0 4 0 0 0 0 0 0 0 0 0 0 0 0 0 0 0 0 0 0 
0 0 0 0 0 0 0 0 0 0 0 0 0 0 4 4 4 4 4 0 0 0 0 0 0 0 4 4 4 0 0 0 0 0 0 0 0 0 4 0 0 0 0 0 0 0 
0 0 0 0 0 0 0 4 4 4 0 0 0 0 4 4 4 4 4 4 0 0 0 0 0 4 4 4 4 4 0 0 0 0 0 0 0 4 4 4 0 0 0 0 0 0 
0 0 0 0 0 0 4 4 4 4 0 0 0 0 4 4 4 4 4 4 0 0 0 0 4 4 4 4 4 4 0 0 0 0 0 0 4 4 4 4 4 0 0 0 0 0 
0 0 0 0 0 0 4 4 4 4 4 0 0 0 4 4 9 9 4 4 0 0 0 0 4 4 4 4 4 4 0 0 0 0 0 4 4 4 4 4 4 0 0 0 0 0 
0 0 0 0 0 4 4 4 4 4 4 0 0 0 4 4 9 9 4 0 0 0 0 0 4 4 9 9 4 4 0 0 0 0 0 4 4 4 4 4 4 0 0 0 0 0 
0 0 0 0 0 4 4 9 9 4 4 0 0 0 0 4 9 9 4 0 0 0 0 0 0 4 9 9 4 0 0 0 0 0 0 4 4 9 9 4 4 0 0 0 0 0 
0 0 0 0 0 0 4 9 9 4 0 0 0 0 0 0 9 9 0 0 0 0 0 0 0 0 9 9 0 0 0 0 0 0 0 0 4 9 9 4 0 0 0 0 0 0 
0 0 0 0 0 0 0 9 9 0 0 0 0 0 0 0 9 9 0 0 0 0 0 0 0 0 9 9 0 0 0 0 0 0 0 0 0 9 9 0 0 0 0 0 0 0 
1 1 1 1 1 1 1 1 1 1 1 1 1 1 1 1 1 1 1 1 1 1 1 1 1 1 1 1 1 1 1 1 1 1 1 1 1 1 1 1 1 1 1 1 1 1 
3 2 2 2 3 3 3 3 2 2 2 2 2 2 2 2 2 2 3 3 3 3 3 3 3 3 3 2 2 2 2 2 2 2 2 2 3 3 3 3 3 3 3 3 3 3 
3 2 2 2 3 3 3 3 2 2 2 2 2 2 2 2 2 2 2 3 3 3 3 3 3 3 2 2 2 2 2 2 2 2 2 2 3 3 3 3 3 3 3 3 3 3 
3 2 2 2 3 3 3 3 2 2 2 2 2 2 2 2 2 2 2 2 3 3 3 3 3 2 2 2 2 2 2 2 2 2 2 2 3 3 3 3 3 3 3 3 3 3 
3 2 2 2 3 3 3 3 2 2 2 1 1 1 2 2 2 2 2 2 3 3 3 3 3 2 2 2 2 2 2 1 1 1 1 1 3 3 3 3 3 3 3 3 3 3 
3 2 2 2 3 3 3 3 2 2 2 3 3 3 2 2 2 2 2 2 2 3 3 3 2 2 2 2 2 2 2 3 3 3 3 3 3 3 3 3 3 3 3 3 3 3 
3 2 2 2 3 3 3 3 2 2 2 3 3 3 2 2 2 1 2 2 2 3 3 3 2 2 2 1 2 2 2 2 2 2 3 3 3 2 2 3 3 2 2 3 3 3 
3 2 2 2 3 3 3 3 2 2 2 3 3 3 2 2 2 3 2 2 2 2 3 2 2 2 2 3 2 2 2 2 2 2 3 3 2 2 2 2 2 2 2 2 3 3 
3 2 2 2 3 3 3 3 2 2 2 3 3 3 2 2 2 3 1 2 2 2 3 2 2 2 1 3 2 2 2 1 1 1 3 3 2 2 2 2 2 2 2 2 3 3 
3 2 2 2 3 3 3 3 2 2 2 3 3 3 2 2 2 3 3 2 2 2 2 2 2 2 3 3 2 2 2 3 3 3 3 3 2 2 2 2 2 2 2 2 3 3 
3 2 2 2 2 2 2 2 2 2 2 2 2 2 2 2 2 3 3 1 2 2 2 2 2 1 3 3 2 2 2 2 2 2 2 2 2 2 2 2 2 2 2 1 3 3 
3 2 2 2 2 2 2 2 2 2 2 2 2 2 2 2 2 3 3 3 2 2 2 2 2 3 3 3 2 2 2 2 2 2 2 2 2 1 2 2 2 2 1 3 3 3 
3 2 2 2 2 2 2 2 2 2 2 2 2 2 2 2 2 3 3 3 1 2 2 2 1 3 3 3 2 2 2 2 2 2 2 2 2 3 1 2 2 1 3 3 3 3 
3 5 1 1 1 1 1 1 1 1 1 1 1 1 1 1 1 3 3 3 3 1 1 1 3 3 3 3 1 1 1 1 1 1 1 1 1 3 3 6 6 3 3 3 3 3 
3 3 3 3 3 3 3 3 3 3 3 3 3 3 3 3 3 3 3 3 3 3 3 3 3 3 3 3 3 3 3 3 3 3 3 3 3 3 3 3 3 3 3 3 3 3 
3 3 3 3 3 3 3 3 3 3 3 3 3 3 3 3 3 3 3 3 3 3 3 3 3 3 3 3 3 3 3 3 3 3 3 3 3 3 3 3 3 3 3 3 3 3 
3 3 3 3 3 3 3 3 3 3 3 3 3 3 3 3 3 3 3 3 3 3 3 3 3 3 3 3 3 3 3 3 3 3 3 3 3 3 3 3 3 3 3 3 3 3 
3 3 3 3 3 3 3 3 3 3 3 3 3 3 3 3 3 3 3 3 3 3 3 3 3 3 3 3 3 3 3 3 3 3 3 3 3 3 3 3 3 3 3 3 3 3 
3 3 3 3 3 3 3 3 3 3 3 3 3 3 3 3 3 3 3 3 3 3 3 3 3 3 3 3 3 3 3 3 3 3 3 3 3 3 3 3 3 3 3 3 3 3 
3 3 3 3 3 3 3 3 3 3 3 3 3 3 3 3 3 3 3 3 3 3 3 3 3 3 3 3 3 3 3 3 3 3 3 3 3 3 3 3 3 3 3 3 3 3 
0 0 0 0 0 0 0 0 0 0 0 0 0 0 0 0 0 0 0 0 0 0 0 0 0 0 0 0 0 0 0 0 0 0 0 0 0 0 0 0 0 0 0 0 0 0 
0 0 0 0 0 0 0 0 0 0 0 0 0 0 0 0 0 0 0 0 0 0 0 0 0 0 0 0 0 0 0 0 0 0 0 0 0 0 0 0 0 0 0 0 0 0 
