46 32
1 2 3 4 5 6 7 8 9 10 11 12 13 14 15 16 17 18 19 0 0 0 0 0 0 0 0 0 0 0 0 0 0 0 0 0 0 0 0 0 0 0 0 0 0 0 
0 0 0 0 0 0 0 0 0 0 0 0 0 0 0 0 0 0 0 0 0 0 0 0 0 0 0 0 0 0 0 0 0 0 0 0 0 0 0 0 4 4 4 4 4 0 
0 0 0 0 0 0 0 4 4 4 0 0 0 0 0 0 0 0 0 0 0 0 0 0 0 0 0 0 0 0 0 0 0 0 0 0 0 0 0 4 0 0 9 0 0 4 
12 12 0 0 0 0 4 0 9 0 4 0 0 0 0 0 0 0 0 0 0 0 0 0 0 0 0 0 0 0 0 0 0 0 0 0 0 0 0 0 0 0 9 0 0 0 
12 12 12 0 0 0 0 0 9 0 0 0 0 0 0 0 0 0 0 0 0 0 0 0 0 0 0 0 0 0 0 0 0 0 0 0 0 0 0 0 0 0 9 0 0 0 
12 12 12 12 0 0 0 0 9 0 0 0 0 0 0 0 0 0 0 0 0 0 12 12 12 12 12 12 12 12 12 12 0 0 0 0 0 0 0 0 0 0 9 0 0 0 
12 12 12 12 12 12 12 0 9 0 0 0 0 0 0 0 0 0 12 12 12 12 12 12 12 12 12 12 12 12 12 12 12 12 12 12 0 0 0 0 0 0 9 0 0 0 
12 12 12 12 12 12 12 12 12 12 12 12 12 12 12 12 12 12 12 12 12 12 12 12 12 12 12 12 12 12 12 12 12 12 12 12 12 12 0 0 0 0 9 0 0 0 
12 12 12 12 12 12 12 12 12 12 12 12 12 12 12 12 12 12 12 12 12 12 12 12 12 12 12 12 12 12 12 12 12 12 12 12 12 12 12 12 0 0 9 0 0 0 
12 12 12 12 12 12 12 12 12 12 12 12 12 12 12 12 12 12 12 12 12 12 12 12 12 12 12 12 12 12 12 12 12 12 12 12 12 12 12 12 12 12 12 12 12 12 
12 12 12 12 12 12 12 12 12 12 12 12 12 12 12 12 2 2 2 2 2 2 2 2 2 2 12 12 12 12 12 12 12 12 12 12 12 12 12 12 12 12 12 12 12 12 
12 12 12 12 12 12 12 12 12 12 12 12 12 2 2 2 2 2 2 2 2 2 2 2 2 2 12 12 12 12 12 12 12 12 12 12 12 12 12 12 12 12 12 12 12 12 
12 12 12 12 12 12 12 2 2 2 2 2 2 2 2 2 2 2 2 2 2 2 2 2 2 2 12 12 12 12 12 12 12 12 12 12 12 12 12 12 12 12 12 12 12 12 
12 12 12 12 12 12 12 2 2 2 2 2 2 2 2 2 2 2 2 2 2 2 2 2 2 2 12 12 12 12 12 12 12 12 12 12 12 12 12 12 12 12 12 12 12 12 
12 12 12 12 12 12 12 2 2 2 2 2 2 2 2 2 2 2 12 12 12 12 12 2 2 2 12 12 12 12 12 12 12 12 12 12 12 12 12 12 12 12 12 12 12 12 
12 12 12 12 12 12 12 2 2 2 2 2 2 13 13 2 2 2 12 12 12 12 12 2 2 2 12 12 12 12 12 12 12 12 12 12 12 12 12 12 12 12 12 12 12 12 
12 12 12 12 12 12 12 2 2 2 2 12 12 12 12 12 12 12 12 12 12 12 12 2 2 2 12 12 12 12 12 12 12 12 12 12 12 12 12 12 12 12 12 12 12 12 
12 12 12 12 12 12 2 2 2 2 2 12 12 12 12 12 12 12 12 12 12 12 12 2 2 2 12 12 12 12 12 12 12 12 12 12 12 2 2 2 2 2 2 2 12 12 
12 12 12 12 12 2 2 2 2 2 2 12 12 12 12 12 12 12 12 12 12 12 12 2 2 2 12 12 12 12 12 12 12 12 12 2 2 2 2 2 2 2 2 2 2 12 
12 12 12 2 2 2 2 2 2 2 2 12 12 12 12 12 12 12 12 12 12 2 2 2 2 2 12 12 12 12 12 12 2 2 2 2 2 2 2 2 2 2 2 2 2 12 
12 2 2 2 2 2 2 2 2 2 2 12 12 12 12 12 12 12 12 2 2 2 2 2 2 2 12 12 12 12 2 2 2 2 2 2 2 2 2 2 2 2 2 2 2 12 
2 2 2 2 2 2 2 2 2 2 2 12 12 12 12 12 12 2 2 2 2 2 2 2 2 2 12 12 12 2 2 2 2 2 2 2 2 2 2 2 2 2 2 2 2 12 
2 2 2 2 2 2 2 2 2 2 2 12 12 12 12 12 2 2 2 2 2 2 2 2 2 2 12 12 2 2 2 2 2 2 2 2 2 2 2 13 13 2 2 2 2 12 
2 2 2 2 2 12 12 12 12 12 12 12 12 12 12 12 2 2 2 2 2 2 2 12 12 12 12 2 2 2 2 2 2 2 2 2 2 12 12 12 12 6 6 12 12 12 
2 2 2 2 2 12 12 12 12 12 12 12 12 12 12 12 2 2 2 2 2 12 12 12 12 12 2 2 2 2 2 2 2 2 2 2 2 12 12 12 12 12 12 12 12 12 
5 12 12 2 2 12 12 12 12 12 12 12 12 12 12 12 2 2 2 2 2 2 2 2 2 2 2 2 2 2 2 2 12 12 12 12 12 12 12 12 12 12 12 12 12 12 
12 12 12 2 2 12 12 12 12 12 12 12 12 12 12 12 2 2 2 2 2 2 2 2 2 2 2 2 2 2 2 2 12 12 12 12 12 12 12 12 12 12 12 12 12 12 
12 12 12 2 2 12 12 12 12 12 12 12 12 12 12 12 12 12 2 2 2 2 2 2 2 2 2 2 2 12 12 12 12 12 12 12 12 12 12 12 12 12 12 12 12 12 
12 12 12 2 2 12 12 12 12 12 12 12 12 12 12 12 12 12 2 2 2 12 12 12 12 12 12 12 12 12 12 12 12 12 12 12 12 12 12 12 12 12 12 12 12 12 
12 12 12 2 2 12 12 12 12 12 0 12 0 12 12 12 12 12 12 12 12 12 12 12 12 12 12 12 12 12 12 12 12 12 12 12 12 12 12 12 12 12 12 12 12 12 
0 0 0 0 0 0 0 0 0 0 0 0 0 0 0 0 0 0 0 0 0 0 0 0 0 0 0 0 0 0 0 0 0 0 0 0 0 0 0 0 0 0 0 0 0 0 
0 0 0 0 0 0 0 0 0 0 0 0 0 0 0 0 0 0 0 0 0 0 0 0 0 0 0 0 0 0 0 0 0 0 0 0 0 0 0 0 0 0 0 0 0 0 
